8 8 3
00011100
00014100
11113100
16522111
11132341
00121111
00141000
00111000
